11111111111
1E000000001
10100101101
10100100101
1P0000000C1
11111111111
