1111111111111111111111111111111111
1C0000000000000C00000C000000000001
11100101001000001010010000000101C1
1010011111101010001001000000010111
10P00000EC10C0000000000000000000C1
1111111111111111111111111111111111
